0000000000000000000000000
0000200000002000000020000
0011111111111111111111100
0000000000000000000000000
0000000000000000000000000
0000000000000000000000000
0000000000007000000000000
0011111111111111111111100
0000000000000000000000000
0000000000000000000000000
0000000000000000000000000
0000040000000000000000000
001111111000000011111110000000000000000000000000000000000000000000000000000000000000000000000000000000000000000000000000000000000000000000000000000000

